     #######   
    #    ## #  
   #   #     # 
   # ######### 
   # ##        
 ### ## # # ###
#    ## # # # #
# ##    #     #
#  # # ####### 
## # #       # 
#  # ### ### # 
# ##   # ### # 
P ### ## # # # 
# ##  #  #   # 
 ### ####### # 
   # # # #   # 
   # # # ### # 
   #   # #   # 
    ###   ###  