     #######   
    #       #  
   #         # 
   #  ######## 
   #  #       #
 ###  #       #
#  #  #       #
#  #  #       #
#  #   ####### 
#  #         # 
#  #         # 
#  #    P    # 
#  #         # 
#  #         # 
 ###   ####  # 
   #   # #   # 
   #   # #   # 
   #   # #   # 
    ###   ###  