################
#              #
#              #
#        #     #
#              #
#     P  #     #
#              #
#        #     #
#              #
#              #
################