##########
#   #     
# ### ####
#        #
###### # #
#    # # #
# ## # # #
# #  # # #
P #    # #
##########